1111111111111111111111111111111111111
1P00000000C00000000C00000000C00000001
1000111100100001010100001000011111001
10010000101000010101000010000100C0001
101000000010C0010101000010000100C0001
1010000000100001010100001000011110001
101001111010000101C10000100001CC00001
100100C01010CC01010100001000010000001
1000111100011110010111101111C11111001
100000000000C00000000000000000000E001
1111111111111111111111111111111111111