1111111111111111111111111111111111111
1P00000000C00000000C00000000C00000001
100011110010000101010000100C011111001
10010C0010100001C1C10000100001C0C0001
1C1000C00010C00101010000100C0100C0001
1010000000100001010100001000011110001
1C1001111010000101C10000100C01CC00001
100100C01010CC01010100001000010000001
1C00111100011110010111101111C11111001
1000C0000C00C00000000C00C00C00000E001
1111111111111111111111111111111111111