1111111111111111111111111111111111111
1000C00000C00000000C00000000C000CCC01
101111110010CCC101010000100C011111001
10C10C00101000C1C1C10000100001C0C0001
1C1000C00010C0C101010000100C0100C0001
1010000000100001010110111000011110001
1C1000C00010C0P101010000100C0100C0001
1C1000C00011101101010000100C0100C0001
1C1000C00010CCC10111000011111100C0001
1C1000C00010C0C1C1010000100C0100C0001
1C1000C00010C001C1C11111100C0100C0001
1C1000C00010C0C1C1C10000100C0100C0001
1C1000C00010C00101010000100C0100C0001
1C1000C00010C00101010000100C0100C0001
1C1001111010000101C10000100C01CC00001
100100C01010CC0101010000100001000CC01
1C00111100011110010111101111C11111001
1000C0100CCCC00000000C00C00C0000CEC01
1111111111111111111111111111111111111