1111111111111111111111111111111111111111
1P00000000000000000000000000000000000001
100CCCCC00C00000C0C0C00000C00000CCCCCC01
10C00000C0C00000C0C0C00000C00000C0000001
1C00000000C00000C0C0C00000C00000C0000001
1C00000000C00000C0C0C00000C00000CCCCCC01
1C000CCCC0C00000C0C0C00000C00000C0000001
10C00000C0C00000C0C0C00000C00000C0000001
100CCCCC000CCCCC00C0CCCCC0CCCCC0CCCCCC01
100000000000000000000000000000000000E001
1111111111111111111111111111111111111111