11111111111
10010C010C1
1C01CE01011
1011C001001
1000000C011
11100PC00C1
11111111111