111111111111
10P000000001
100C00000001
10000000E001
1000000C0001
111111111111