111111111111
1000P0000001
100C00000001
100X0E000001
1000000C0001
111111111111