111111111111111111111111111111111111111111111111111111111111111111111111111
1P00000000C00000000C00000000C0000000000000000000000000000000000000000000001
100000000010000000010000000010000000000000000000000000000000000000000000001
100000000010000000010000000010000000000000000000000000000000000000000000001
100000000010000000010000000010000000000000000000000000000000000000000000001
100000000010000000010000000010000000000000000000000000000000000000000000001
100000000010000000010000000010000000000000000000000000000000000000000000001
100000000010000000010000000010000000000000000000000000000000000000000000001
100000000010000000010000000010000000000000000000000000000000000000000000001
100000000010000000010000000010000000000000000000000000000000000000000000001
100000000010000000010000000010000000000000000000000000000000000000000000001
100000000010000000010000000010000000000000000000000000000000000000000000001
100000000010000000010000000010000000000000000000000000000000000000000000001
100000000010000000010000000010000000000000000000000000000000000000000000001
100000000010000000010000000010000000000000000000000000000000000000000000001
100000000010000000010000000010000000000000000000000000000000000000000000001
100000000010000000010000000010000000000000000000000000000000000000000000001
100000000010000000010000000010000000000000000000000000000000000000000000001
100000000010000000010000000010000000000000000000000000000000000000000000001
100000000010000000010000000010000000000000000000000000000000000000000000001
100000000010000000010000000010000000000000000000000000000000000000000000001
100000000010000000010000000010000000000000000000000000000000000000000000001
100000000010000000010000000010000000000000000000000000000000000000000000001
100000000010000000010000000010000000000000000000000000000000000000000000001
100000000010000000010000000010000000000000000000000000000000000000000000001
100000000010000000010000000010000000000000000000000000000000000000000000001
100000000010000000010000000010000000000000000000000000000000000000000000001
100000000010000000010000000010000000000000000000000000000000000000000000001
100000000010000000010000000010000000000000000000000000000000000000000000001
100000000010000000010000000010000000000000000000000000000000000000000000001
100000000010000000010000000010000000000000000000000000000000000000000000001
100000000010000000010000000010000000000000000000000000000000000000000000001
100000000010000000010000000010000000000000000000000000000000000000000000001
100000000010000000010000000010000000000000000000000000000000000000000000001
100000000010000000010000000010000000000000000000000000000000000000000000001
100000000010000000010000000010000000000000000000000000000000000000000000001
1000C0000C00C00000000C00C00C00000E00000000000000000000000000000000000000001
111111111111111111111111111111111111111111111111111111111111111111111111111
