1111111111111
1CE10111111C1
1000011111001
110P000000011
1111111111111