111111111111
1000P0000001
100000000001
10000E000001
100000000001
111111111111