111111111111
1000P0000001
111100011111
10000E001111
1000000010C1
111111111111