1111111111111111111111111111111111111111111111111111111111111111111111111111111111111111111111111
1P00000000C00000000C00000000C00000000000000000000000000000000000000000000000000000000000000000001
1000000000100000000100000000100000000000000000000000000000000000000000000000000000000000000000001
1000000000100000000100000000100000000000000000000000000000000000000000000000000000000000000000001
1000000000100000000100000000100000000000000000000000000000000000000000000000000000000000000000001
1000000000100000000100000000100000000000000000000000000000000000000000000000000000000000000000001
1000000000100000000100000000100000000000000000000000000000000000000000000000000000000000000000001
1000000000100000000100000000100000000000000000000000000000000000000000000000000000000000000000001
1000000000100000000100000000100000000000000000000000000000000000000000000000000000000000000000001
1000000000100000000100000000100000000000000000000000000000000000000000000000000000000000000000001
1000000000100000000100000000100000000000000000000000000000000000000000000000000000000000000000001
1000000000100000000100000000100000000000000000000000000000000000000000000000000000000000000000001
1000000000100000000100000000100000000000000000000000000000000000000000000000000000000000000000001
1000000000100000000100000000100000000000000000000000000000000000000000000000000000000000000000001
1000000000100000000100000000100000000000000000000000000000000000000000000000000000000000000000001
1000000000100000000100000000100000000000000000000000000000000000000000000000000000000000000000001
1000000000100000000100000000100000000000000000000000000000000000000000000000000000000000000000001
1000000000100000000100000000100000000000000000000000000000000000000000000000000000000000000000001
1000000000100000000100000000100000000000000000000000000000000000000000000000000000000000000000001
1000000000100000000100000000100000000000000000000000000000000000000000000000000000000000000000001
1000000000100000000100000000100000000000000000000000000000000000000000000000000000000000000000001
1000000000100000000100000000100000000000000000000000000000000000000000000000000000000000000000001
1000000000100000000100000000100000000000000000000000000000000000000000000000000000000000000000001
1000000000100000000100000000100000000000000000000000000000000000000000000000000000000000000000001
1000000000100000000100000000100000000000000000000000000000000000000000000000000000000000000000001
1000000000100000000100000000100000000000000000000000000000000000000000000000000000000000000000001
1000000000100000000100000000100000000000000000000000000000000000000000000000000000000000000000001
1000000000100000000100000000100000000000000000000000000000000000000000000000000000000000000000001
1000000000100000000100000000100000000000000000000000000000000000000000000000000000000000000000001
1000000000100000000100000000100000000000000000000000000000000000000000000000000000000000000000001
1000000000100000000100000000100000000000000000000000000000000000000000000000000000000000000000001
1000000000100000000100000000100000000000000000000000000000000000000000000000000000000000000000001
1000000000100000000100000000100000000000000000000000000000000000000000000000000000000000000000001
1000000000100000000100000000100000000000000000000000000000000000000000000000000000000000000000001
1000000000100000000100000000100000000000000000000000000000000000000000000000000000000000000000001
1000000000100000000100000000100000000000000000000000000000000000000000000000000000000000000000001
1000000000100000000100000000100000000000000000000000000000000000000000000000000000000000000000001
1000000000100000000100000000100000000000000000000000000000000000000000000000000000000000000000001
1000C0000C00C00000000C00C00C00000E000000000000000000000000000000000000000000000000000000000000001
1111111111111111111111111111111111111111111111111111111111111111111111111111111111111111111111111
